############
#  #       G
# ## # # ###
S          #
# # # # # ## 
# # # # # ##
############
