############
#          G
## # ##  ###
##  #S   ###
### ##     # 
###     ####
